111111111111111111111111
10000000100000C110000001
1C0000001000000000C11001
10000000C000000100000011
100000001000000000000001
1EM00000000000C11100P001
111111111111111111111111
